//MAP CONVERTED BY dmm2tgm.py THIS HEADER COMMENT PREVENTS RECONVERSION, DO NOT REMOVE
"aM" = (
/turf/open/floor/engine{
	initial_gas_mix = "ws_atmos"
	},
/area/whitesands/surface/outdoors/unexplored)
"bV" = (
/obj/machinery/portable_atmospherics/canister/toxins,
/turf/open/floor/plating{
	icon_state = "panelscorched";
	initial_gas_mix = "ws_atmos"
	},
/area/whitesands/surface/outdoors/unexplored)
"cG" = (
/obj/item/toy/plush/lizardplushie,
/turf/open/floor/plating/asteroid/whitesands,
/area/whitesands/surface/outdoors/unexplored)
"dv" = (
/obj/machinery/atmospherics/pipe/simple/scrubbers{
	dir = 5
	},
/turf/open/floor/plating{
	icon_state = "platingdmg1";
	initial_gas_mix = "ws_atmos"
	},
/area/whitesands/surface/outdoors/unexplored)
"dJ" = (
/obj/machinery/atmospherics/pipe/simple/cyan/visible{
	dir = 9
	},
/turf/open/floor/plating{
	icon_state = "platingdmg1";
	initial_gas_mix = "ws_atmos"
	},
/area/whitesands/surface/outdoors/unexplored)
"ey" = (
/obj/machinery/atmospherics/components/unary/portables_connector/visible,
/obj/machinery/portable_atmospherics/canister/toxins,
/turf/open/floor/plating{
	icon_state = "panelscorched";
	initial_gas_mix = "ws_atmos"
	},
/area/whitesands/surface/outdoors/unexplored)
"eR" = (
/obj/machinery/atmospherics/pipe/simple/scrubbers,
/turf/open/floor/plating{
	icon_state = "panelscorched";
	initial_gas_mix = "ws_atmos"
	},
/area/whitesands/surface/outdoors/unexplored)
"ff" = (
/obj/item/clothing/neck/stethoscope,
/turf/open/floor/plating{
	initial_gas_mix = "ws_atmos"
	},
/area/whitesands/surface/outdoors/unexplored)
"fm" = (
/obj/machinery/suit_storage_unit{
	mask_type = /obj/item/clothing/mask/gas/syndicate;
	storage_type = null
	},
/turf/open/floor/mineral/plastitanium/red{
	initial_gas_mix = "ws_atmos"
	},
/area/whitesands/surface/outdoors/unexplored)
"fx" = (
/obj/item/storage/firstaid/ancient,
/turf/open/floor/plating/asteroid/whitesands,
/area/whitesands/surface/outdoors/unexplored)
"fy" = (
/obj/effect/turf_decal/tile/blue,
/obj/effect/turf_decal/tile/blue{
	dir = 8
	},
/turf/open/floor/plasteel/dark,
/area/whitesands/surface/outdoors/unexplored)
"fz" = (
/obj/effect/turf_decal/bot,
/obj/machinery/portable_atmospherics/canister/toxins,
/obj/machinery/atmospherics/components/unary/portables_connector/visible{
	dir = 8
	},
/turf/open/floor/plasteel/dark,
/area/whitesands/surface/outdoors/unexplored)
"gr" = (
/obj/structure/frame/machine,
/obj/item/circuitboard/machine/sleeper,
/turf/open/floor/plating{
	icon_state = "panelscorched";
	initial_gas_mix = "ws_atmos"
	},
/area/whitesands/surface/outdoors/unexplored)
"gG" = (
/obj/machinery/atmospherics/pipe/simple/scrubbers,
/turf/open/floor/plating{
	icon_state = "platingdmg1";
	initial_gas_mix = "ws_atmos"
	},
/area/whitesands/surface/outdoors/unexplored)
"gT" = (
/obj/structure/door_assembly/door_assembly_hatch,
/turf/open/floor/plating{
	initial_gas_mix = "ws_atmos"
	},
/area/whitesands/surface/outdoors/unexplored)
"ht" = (
/obj/machinery/atmospherics/pipe/simple/scrubbers{
	dir = 8
	},
/turf/open/floor/plating{
	icon_state = "panelscorched";
	initial_gas_mix = "ws_atmos"
	},
/area/whitesands/surface/outdoors/unexplored)
"hD" = (
/obj/item/stack/tile/plasteel,
/turf/open/floor/plating/asteroid/whitesands/dried,
/area/whitesands/surface/outdoors/unexplored)
"hS" = (
/obj/item/pickaxe/improvised,
/turf/open/floor/plating/asteroid/whitesands,
/area/whitesands/surface/outdoors/unexplored)
"hW" = (
/obj/effect/turf_decal/stripes/white{
	dir = 1
	},
/obj/machinery/atmospherics/pipe/simple/dark/visible{
	dir = 8
	},
/turf/open/floor/engine{
	initial_gas_mix = "ws_atmos"
	},
/area/whitesands/surface/outdoors/unexplored)
"iD" = (
/obj/machinery/atmospherics/pipe/manifold/scrubbers/visible{
	dir = 4
	},
/turf/open/floor/engine{
	initial_gas_mix = "ws_atmos"
	},
/area/whitesands/surface/outdoors/unexplored)
"iQ" = (
/turf/open/floor/plating{
	initial_gas_mix = "ws_atmos"
	},
/area/whitesands/surface/outdoors/unexplored)
"jB" = (
/obj/effect/decal/cleanable/ash,
/obj/item/paper{
	desc = null;
	info = "Well, we failed. The undoable has been done. We were taken out. The great Starfury is stuck in orbit, and many of our systems are damaged. There is no other choice but to evacuate. However, me and a group of talented indviduals will go with me. I will activate the hyperdrive, one last time to scuttle the ship before Nanotrasen can get their grubby little hands on it, on the planet of our greatest victory.  If you are worried about me, I have my tegu plushie and all i need to survive for a year. Men and women, its been a honour.";
	name = "Starfury Status Report - January 15th, 2501"
	},
/turf/open/floor/plating{
	icon_state = "panelscorched";
	initial_gas_mix = "ws_atmos"
	},
/area/whitesands/surface/outdoors/unexplored)
"kq" = (
/mob/living/simple_animal/hostile/syndicate/ranged/space/stormtrooper,
/turf/open/floor/plating{
	icon_state = "panelscorched";
	initial_gas_mix = "ws_atmos"
	},
/area/whitesands/surface/outdoors/unexplored)
"kP" = (
/obj/item/storage/toolbox/syndicate,
/turf/open/floor/engine{
	initial_gas_mix = "ws_atmos"
	},
/area/whitesands/surface/outdoors/unexplored)
"lm" = (
/obj/machinery/power/generator,
/turf/open/floor/engine{
	initial_gas_mix = "ws_atmos"
	},
/area/whitesands/surface/outdoors/unexplored)
"mb" = (
/obj/machinery/atmospherics/components/binary/pump{
	dir = 1
	},
/turf/open/floor/plating{
	icon_state = "platingdmg1";
	initial_gas_mix = "ws_atmos"
	},
/area/whitesands/surface/outdoors/unexplored)
"mC" = (
/obj/structure/window/plasma/reinforced/plastitanium/unanchored,
/obj/machinery/atmospherics/pipe/simple/scrubbers,
/turf/open/floor/plating{
	icon_state = "platingdmg1"
	},
/area/whitesands/surface/outdoors/unexplored)
"mM" = (
/obj/effect/turf_decal/stripes/white{
	dir = 1
	},
/obj/machinery/atmospherics/pipe/simple/dark/visible{
	dir = 5
	},
/turf/open/floor/engine{
	initial_gas_mix = "ws_atmos"
	},
/area/whitesands/surface/outdoors/unexplored)
"mQ" = (
/obj/effect/turf_decal/stripes/white{
	dir = 1
	},
/obj/machinery/atmospherics/pipe/simple/cyan/visible{
	dir = 5
	},
/turf/open/floor/engine{
	initial_gas_mix = "ws_atmos"
	},
/area/whitesands/surface/outdoors/unexplored)
"oO" = (
/obj/machinery/suit_storage_unit,
/turf/open/floor/plating{
	initial_gas_mix = "ws_atmos"
	},
/area/whitesands/surface/outdoors/unexplored)
"oT" = (
/obj/machinery/atmospherics/pipe/simple/cyan/visible,
/turf/open/floor/plating{
	initial_gas_mix = "ws_atmos"
	},
/area/whitesands/surface/outdoors/unexplored)
"pn" = (
/obj/machinery/atmospherics/pipe/simple/scrubbers{
	dir = 8
	},
/turf/open/floor/plating/asteroid/whitesands,
/area/whitesands/surface/outdoors/unexplored)
"qe" = (
/obj/item/clothing/head/hardhat/red{
	desc = "A piece of headgear used in dangerous working conditions to protect the head. On closer inspection it apears to be a regular hardhat painted red.";
	name = "syndicate hardhat"
	},
/obj/machinery/atmospherics/components/unary/portables_connector/visible{
	dir = 8
	},
/turf/open/floor/plating{
	icon_state = "panelscorched";
	initial_gas_mix = "ws_atmos"
	},
/area/whitesands/surface/outdoors/unexplored)
"qF" = (
/obj/structure/safe/floor,
/obj/item/clothing/suit/space/hardsuit/syndi,
/obj/item/documents/syndicate,
/turf/open/floor/plating{
	icon_state = "panelscorched";
	initial_gas_mix = "ws_atmos"
	},
/area/whitesands/surface/outdoors/unexplored)
"rt" = (
/obj/structure/frame/machine,
/turf/open/floor/plating{
	initial_gas_mix = "ws_atmos"
	},
/area/whitesands/surface/outdoors/unexplored)
"rG" = (
/obj/effect/turf_decal/stripes/white{
	dir = 8
	},
/turf/open/floor/engine{
	initial_gas_mix = "ws_atmos"
	},
/area/whitesands/surface/outdoors/unexplored)
"rO" = (
/obj/structure/frame/machine,
/obj/item/stack/cable_coil/cut/blue,
/turf/open/floor/mineral/plastitanium/red{
	initial_gas_mix = "ws_atmos"
	},
/area/whitesands/surface/outdoors/unexplored)
"se" = (
/obj/structure/frame/machine,
/obj/item/circuitboard/machine/smes,
/obj/item/stock_parts/capacitor,
/obj/item/stack/cable_coil/cut/blue,
/obj/item/stock_parts/cell/empty,
/turf/open/floor/plating{
	icon_state = "platingdmg2"
	},
/area/whitesands/surface/outdoors/unexplored)
"sr" = (
/turf/open/floor/plating{
	icon_state = "platingdmg2";
	initial_gas_mix = "ws_atmos"
	},
/area/whitesands/surface/outdoors/unexplored)
"sI" = (
/obj/effect/turf_decal/delivery,
/obj/machinery/portable_atmospherics/canister/toxins,
/turf/open/floor/plasteel/dark,
/area/whitesands/surface/outdoors/unexplored)
"sZ" = (
/obj/machinery/atmospherics/pipe/manifold/cyan/visible{
	dir = 8
	},
/turf/open/floor/plating{
	initial_gas_mix = "ws_atmos"
	},
/area/whitesands/surface/outdoors/unexplored)
"tv" = (
/obj/machinery/atmospherics/components/binary/pump,
/turf/open/floor/plating{
	initial_gas_mix = "ws_atmos"
	},
/area/whitesands/surface/outdoors/unexplored)
"tw" = (
/turf/open/floor/plasteel/dark,
/area/whitesands/surface/outdoors/unexplored)
"ue" = (
/obj/effect/turf_decal/bot,
/obj/machinery/portable_atmospherics/canister/toxins,
/obj/machinery/atmospherics/components/unary/portables_connector/visible{
	dir = 4
	},
/turf/open/floor/plasteel/dark,
/area/whitesands/surface/outdoors/unexplored)
"ur" = (
/obj/effect/turf_decal/stripes/white{
	dir = 1
	},
/turf/open/floor/engine{
	initial_gas_mix = "ws_atmos"
	},
/area/whitesands/surface/outdoors/unexplored)
"uy" = (
/obj/effect/decal/cleanable/ash,
/obj/effect/decal/cleanable/ash{
	pixel_x = 3;
	pixel_y = -3
	},
/obj/effect/decal/cleanable/ash{
	pixel_x = 2;
	pixel_y = -2
	},
/turf/open/floor/plating{
	icon_state = "panelscorched";
	initial_gas_mix = "ws_atmos"
	},
/area/whitesands/surface/outdoors/unexplored)
"uz" = (
/obj/machinery/atmospherics/pipe/simple/cyan/visible{
	dir = 10
	},
/turf/open/floor/plating{
	initial_gas_mix = "ws_atmos"
	},
/area/whitesands/surface/outdoors/unexplored)
"uB" = (
/obj/machinery/atmospherics/pipe/manifold/cyan/visible{
	dir = 8
	},
/turf/open/floor/engine{
	initial_gas_mix = "ws_atmos"
	},
/area/whitesands/surface/outdoors/unexplored)
"uW" = (
/obj/item/stack/sheet/metal,
/turf/open/floor/plating/asteroid/whitesands,
/area/whitesands/surface/outdoors/unexplored)
"vl" = (
/obj/structure/window/plasma/reinforced/plastitanium/unanchored,
/turf/open/floor/plating{
	icon_state = "platingdmg1"
	},
/area/whitesands/surface/outdoors/unexplored)
"vJ" = (
/obj/machinery/door/airlock/hatch,
/turf/open/floor/plasteel/dark,
/area/whitesands/surface/outdoors/unexplored)
"vW" = (
/obj/machinery/door/airlock/engineering,
/turf/open/floor/plating,
/area/whitesands/surface/outdoors/unexplored)
"wr" = (
/obj/machinery/atmospherics/pipe/simple/cyan/visible,
/obj/item/pipe_dispenser,
/turf/open/floor/plating{
	icon_state = "panelscorched";
	initial_gas_mix = "ws_atmos"
	},
/area/whitesands/surface/outdoors/unexplored)
"wB" = (
/obj/machinery/portable_atmospherics/scrubber,
/turf/open/floor/plating/asteroid/whitesands,
/area/whitesands/surface/outdoors/unexplored)
"wY" = (
/obj/machinery/atmospherics/components/unary/portables_connector/visible,
/obj/machinery/portable_atmospherics/canister/oxygen,
/turf/open/floor/plating{
	icon_state = "platingdmg1";
	initial_gas_mix = "ws_atmos"
	},
/area/whitesands/surface/outdoors/unexplored)
"yl" = (
/obj/structure/chair/comfy,
/turf/open/floor/plating{
	icon_state = "panelscorched";
	initial_gas_mix = "ws_atmos"
	},
/area/whitesands/surface/outdoors/unexplored)
"yL" = (
/turf/open/floor/plating{
	icon_state = "platingdmg1";
	initial_gas_mix = "ws_atmos"
	},
/area/whitesands/surface/outdoors/unexplored)
"yM" = (
/obj/item/clothing/shoes/jackboots,
/turf/open/floor/plating/asteroid/whitesands,
/area/whitesands/surface/outdoors/unexplored)
"Aj" = (
/obj/item/stock_parts/cell/empty{
	pixel_x = 5;
	pixel_y = -6
	},
/obj/machinery/power/terminal{
	dir = 1
	},
/turf/open/floor/plating/asteroid/whitesands/dried,
/area/whitesands/surface/outdoors/unexplored)
"Av" = (
/turf/closed/mineral/random/whitesands,
/area/template_noop)
"AF" = (
/obj/effect/turf_decal/loading_area/red,
/turf/open/floor/plasteel/dark,
/area/whitesands/surface/outdoors/unexplored)
"BC" = (
/obj/machinery/atmospherics/pipe/manifold/cyan/visible,
/turf/open/floor/engine{
	initial_gas_mix = "ws_atmos"
	},
/area/whitesands/surface/outdoors/unexplored)
"BY" = (
/obj/effect/turf_decal/stripes/white{
	dir = 5
	},
/turf/open/floor/engine{
	initial_gas_mix = "ws_atmos"
	},
/area/whitesands/surface/outdoors/unexplored)
"Dc" = (
/obj/machinery/atmospherics/pipe/simple/scrubbers{
	dir = 8
	},
/turf/open/floor/engine{
	initial_gas_mix = "ws_atmos"
	},
/area/whitesands/surface/outdoors/unexplored)
"Dl" = (
/obj/item/stack/sheet/metal,
/obj/item/stack/sheet/metal,
/turf/open/floor/plating/asteroid/whitesands,
/area/whitesands/surface/outdoors/unexplored)
"Dn" = (
/obj/effect/turf_decal/tile/yellow{
	dir = 4
	},
/turf/open/floor/plasteel/dark,
/area/whitesands/surface/outdoors/unexplored)
"DK" = (
/turf/open/floor/mineral/plastitanium/red{
	initial_gas_mix = "ws_atmos"
	},
/area/whitesands/surface/outdoors/unexplored)
"Ec" = (
/obj/effect/decal/remains/human,
/obj/effect/decal/cleanable/blood/old,
/obj/item/clothing/under/syndicate{
	pixel_y = -11
	},
/turf/open/floor/plating/asteroid/whitesands,
/area/whitesands/surface/outdoors/unexplored)
"Ee" = (
/obj/machinery/atmospherics/components/unary/thermomachine/freezer{
	dir = 8
	},
/turf/open/floor/engine{
	initial_gas_mix = "ws_atmos"
	},
/area/whitesands/surface/outdoors/unexplored)
"EF" = (
/obj/machinery/atmospherics/components/binary/pump,
/turf/open/floor/engine{
	initial_gas_mix = "ws_atmos"
	},
/area/whitesands/surface/outdoors/unexplored)
"EG" = (
/obj/effect/turf_decal/tile/blue,
/turf/open/floor/plasteel/dark,
/area/whitesands/surface/outdoors/unexplored)
"EI" = (
/obj/machinery/atmospherics/components/binary/circulator/cold{
	dir = 8
	},
/turf/open/floor/engine{
	initial_gas_mix = "ws_atmos"
	},
/area/whitesands/surface/outdoors/unexplored)
"EJ" = (
/obj/machinery/atmospherics/pipe/simple/dark/visible{
	dir = 5
	},
/turf/open/floor/plating/asteroid/whitesands{
	dir = 8
	},
/area/whitesands/surface/outdoors/unexplored)
"Fd" = (
/mob/living/simple_animal/hostile/syndicate/ranged/space,
/turf/open/floor/plating{
	initial_gas_mix = "ws_atmos"
	},
/area/whitesands/surface/outdoors/unexplored)
"Fk" = (
/obj/machinery/portable_atmospherics/scrubber,
/turf/open/floor/plating{
	icon_state = "platingdmg1";
	initial_gas_mix = "ws_atmos"
	},
/area/whitesands/surface/outdoors/unexplored)
"Fu" = (
/obj/machinery/atmospherics/pipe/manifold/dark/visible{
	dir = 4
	},
/turf/open/floor/engine{
	initial_gas_mix = "ws_atmos"
	},
/area/whitesands/surface/outdoors/unexplored)
"Fw" = (
/obj/effect/turf_decal/tile/yellow{
	dir = 4
	},
/obj/effect/turf_decal/tile/yellow{
	dir = 1
	},
/turf/open/floor/plasteel/dark,
/area/whitesands/surface/outdoors/unexplored)
"FZ" = (
/obj/item/stock_parts/cell/empty,
/obj/item/stock_parts/cell/empty{
	pixel_x = -8;
	pixel_y = -7
	},
/obj/item/stock_parts/cell/empty{
	pixel_x = 6;
	pixel_y = -10
	},
/obj/item/storage/box/stockparts/deluxe,
/turf/open/floor/plating/asteroid/whitesands,
/area/whitesands/surface/outdoors/unexplored)
"Gi" = (
/obj/effect/turf_decal/stripes/white{
	dir = 1
	},
/obj/machinery/atmospherics/components/binary/pump,
/obj/machinery/atmospherics/pipe/simple/dark/visible{
	dir = 8
	},
/turf/open/floor/engine{
	initial_gas_mix = "ws_atmos"
	},
/area/whitesands/surface/outdoors/unexplored)
"Hh" = (
/obj/machinery/atmospherics/pipe/simple/cyan/visible,
/turf/open/floor/engine{
	initial_gas_mix = "ws_atmos"
	},
/area/whitesands/surface/outdoors/unexplored)
"HR" = (
/obj/machinery/atmospherics/pipe/simple/scrubbers{
	dir = 10
	},
/turf/open/floor/plating{
	icon_state = "platingdmg1";
	initial_gas_mix = "ws_atmos"
	},
/area/whitesands/surface/outdoors/unexplored)
"HV" = (
/obj/effect/turf_decal/stripes/white{
	dir = 1
	},
/obj/machinery/atmospherics/pipe/simple/scrubbers,
/turf/open/floor/engine{
	initial_gas_mix = "ws_atmos"
	},
/area/whitesands/surface/outdoors/unexplored)
"IF" = (
/obj/machinery/atmospherics/pipe/simple/cyan/visible{
	dir = 6
	},
/turf/open/floor/engine{
	initial_gas_mix = "ws_atmos"
	},
/area/whitesands/surface/outdoors/unexplored)
"II" = (
/obj/machinery/atmospherics/pipe/simple/cyan/visible{
	dir = 8
	},
/turf/open/floor/plating{
	icon_state = "platingdmg1";
	initial_gas_mix = "ws_atmos"
	},
/area/whitesands/surface/outdoors/unexplored)
"IR" = (
/obj/item/stack/cable_coil/cut/blue,
/obj/item/stack/tile/plasteel,
/turf/open/floor/plating/asteroid/whitesands/dried,
/area/whitesands/surface/outdoors/unexplored)
"Jl" = (
/obj/item/stack/sheet/metal,
/obj/machinery/atmospherics/components/binary/pump{
	dir = 1
	},
/turf/open/floor/plating/asteroid/whitesands,
/area/whitesands/surface/outdoors/unexplored)
"Jw" = (
/obj/machinery/atmospherics/pipe/manifold/scrubbers/visible{
	dir = 4
	},
/turf/open/floor/plating{
	icon_state = "platingdmg1";
	initial_gas_mix = "ws_atmos"
	},
/area/whitesands/surface/outdoors/unexplored)
"JC" = (
/obj/machinery/atmospherics/pipe/simple/dark/visible{
	dir = 10
	},
/turf/open/floor/plating{
	icon_state = "platingdmg1";
	initial_gas_mix = "ws_atmos"
	},
/area/whitesands/surface/outdoors/unexplored)
"JT" = (
/turf/open/floor/pod/dark,
/area/whitesands/surface/outdoors/unexplored)
"JX" = (
/obj/structure/frame/machine,
/turf/open/floor/engine{
	initial_gas_mix = "ws_atmos"
	},
/area/whitesands/surface/outdoors/unexplored)
"Kg" = (
/obj/effect/turf_decal/stripes/corner{
	dir = 4
	},
/obj/machinery/atmospherics/pipe/simple/scrubbers{
	dir = 6
	},
/turf/open/floor/engine{
	initial_gas_mix = "ws_atmos"
	},
/area/whitesands/surface/outdoors/unexplored)
"Ki" = (
/turf/open/floor/plating{
	icon_state = "panelscorched";
	initial_gas_mix = "ws_atmos"
	},
/area/whitesands/surface/outdoors/unexplored)
"Ku" = (
/mob/living/simple_animal/hostile/syndicate/ranged/shotgun/space,
/turf/open/floor/plating/asteroid/whitesands,
/area/whitesands/surface/outdoors/unexplored)
"Kw" = (
/turf/open/floor/plating/asteroid/whitesands,
/area/whitesands/surface/outdoors/unexplored)
"KE" = (
/obj/item/stack/sheet/metal,
/turf/open/floor/plating{
	icon_state = "platingdmg1";
	initial_gas_mix = "ws_atmos"
	},
/area/whitesands/surface/outdoors/unexplored)
"KT" = (
/obj/machinery/atmospherics/components/binary/pump{
	dir = 4
	},
/turf/open/floor/plating{
	icon_state = "panelscorched";
	initial_gas_mix = "ws_atmos"
	},
/area/whitesands/surface/outdoors/unexplored)
"LB" = (
/obj/item/clothing/gloves/combat,
/turf/open/floor/plating/asteroid/whitesands,
/area/whitesands/surface/outdoors/unexplored)
"Mm" = (
/obj/effect/turf_decal/radiation,
/turf/open/floor/plasteel/dark,
/area/whitesands/surface/outdoors/unexplored)
"MC" = (
/turf/template_noop,
/area/whitesands/surface/outdoors/unexplored)
"MD" = (
/obj/item/stack/sheet/metal,
/turf/open/floor/engine{
	initial_gas_mix = "ws_atmos"
	},
/area/whitesands/surface/outdoors/unexplored)
"NM" = (
/obj/machinery/power/smes,
/turf/open/floor/plating{
	icon_state = "panelscorched"
	},
/area/whitesands/surface/outdoors/unexplored)
"OI" = (
/turf/open/floor/plating,
/area/whitesands/surface/outdoors/unexplored)
"ON" = (
/obj/machinery/power/smes,
/turf/open/floor/plating{
	icon_state = "platingdmg2"
	},
/area/whitesands/surface/outdoors/unexplored)
"OO" = (
/obj/machinery/atmospherics/pipe/manifold/scrubbers/visible,
/turf/open/floor/plating{
	icon_state = "platingdmg1";
	initial_gas_mix = "ws_atmos"
	},
/area/whitesands/surface/outdoors/unexplored)
"Pk" = (
/obj/effect/turf_decal/stripes/white{
	dir = 4
	},
/turf/open/floor/engine{
	initial_gas_mix = "ws_atmos"
	},
/area/whitesands/surface/outdoors/unexplored)
"Pl" = (
/obj/machinery/atmospherics/pipe/simple/cyan/visible{
	dir = 8
	},
/turf/open/floor/plating{
	initial_gas_mix = "ws_atmos"
	},
/area/whitesands/surface/outdoors/unexplored)
"Pm" = (
/obj/machinery/atmospherics/components/unary/portables_connector/visible{
	dir = 4
	},
/obj/effect/turf_decal/bot,
/turf/open/floor/plasteel/dark,
/area/whitesands/surface/outdoors/unexplored)
"PF" = (
/obj/machinery/door/airlock/engineering,
/turf/open/floor/plating{
	initial_gas_mix = "ws_atmos"
	},
/area/whitesands/surface/outdoors/unexplored)
"PZ" = (
/obj/effect/decal/cleanable/ash/large,
/turf/open/floor/plating{
	icon_state = "panelscorched";
	initial_gas_mix = "ws_atmos"
	},
/area/whitesands/surface/outdoors/unexplored)
"Rh" = (
/obj/item/circuitboard/machine/sleeper,
/turf/open/floor/plating{
	icon_state = "platingdmg1";
	initial_gas_mix = "ws_atmos"
	},
/area/whitesands/surface/outdoors/unexplored)
"RJ" = (
/turf/template_noop,
/area/template_noop)
"SG" = (
/mob/living/simple_animal/hostile/syndicate/ranged/smg/space,
/turf/open/floor/plating{
	icon_state = "platingdmg2";
	initial_gas_mix = "ws_atmos"
	},
/area/whitesands/surface/outdoors/unexplored)
"SR" = (
/obj/machinery/atmospherics/components/binary/circulator{
	dir = 4
	},
/turf/open/floor/engine{
	initial_gas_mix = "ws_atmos"
	},
/area/whitesands/surface/outdoors/unexplored)
"Tm" = (
/obj/effect/turf_decal/tile/blue{
	dir = 8
	},
/turf/open/floor/plasteel/dark,
/area/whitesands/surface/outdoors/unexplored)
"Tt" = (
/turf/open/floor/plating/asteroid/whitesands/dried,
/area/whitesands/surface/outdoors/unexplored)
"Uv" = (
/obj/machinery/power/terminal{
	dir = 1
	},
/turf/open/floor/plating{
	icon_state = "platingdmg1"
	},
/area/whitesands/surface/outdoors/unexplored)
"Va" = (
/turf/closed/mineral/random/whitesands,
/area/whitesands/surface/outdoors/unexplored)
"Vc" = (
/turf/open/floor/plating{
	icon_state = "platingdmg1"
	},
/area/whitesands/surface/outdoors/unexplored)
"Vf" = (
/obj/effect/turf_decal/stripes/white{
	dir = 1
	},
/obj/machinery/atmospherics/pipe/simple/cyan/visible{
	dir = 8
	},
/turf/open/floor/engine{
	initial_gas_mix = "ws_atmos"
	},
/area/whitesands/surface/outdoors/unexplored)
"Vi" = (
/obj/machinery/atmospherics/pipe/simple/dark/visible{
	dir = 8
	},
/turf/open/floor/plating{
	icon_state = "platingdmg1";
	initial_gas_mix = "ws_atmos"
	},
/area/whitesands/surface/outdoors/unexplored)
"Vp" = (
/obj/machinery/atmospherics/pipe/simple/scrubbers,
/turf/open/floor/engine{
	initial_gas_mix = "ws_atmos"
	},
/area/whitesands/surface/outdoors/unexplored)
"VA" = (
/obj/machinery/atmospherics/pipe/simple/dark/visible,
/turf/closed/wall/r_wall/syndicate,
/area/whitesands/surface/outdoors/unexplored)
"Wc" = (
/turf/closed/wall/r_wall/syndicate,
/area/whitesands/surface/outdoors/unexplored)
"Wn" = (
/obj/machinery/atmospherics/pipe/simple/scrubbers{
	dir = 10
	},
/turf/open/floor/engine{
	initial_gas_mix = "ws_atmos"
	},
/area/whitesands/surface/outdoors/unexplored)
"Xj" = (
/obj/machinery/atmospherics/pipe/simple/scrubbers{
	dir = 8
	},
/turf/open/floor/plating{
	initial_gas_mix = "ws_atmos"
	},
/area/whitesands/surface/outdoors/unexplored)
"Ym" = (
/obj/machinery/atmospherics/pipe/simple/cyan/visible,
/turf/open/floor/plating{
	icon_state = "platingdmg1";
	initial_gas_mix = "ws_atmos"
	},
/area/whitesands/surface/outdoors/unexplored)
"Yx" = (
/obj/machinery/atmospherics/pipe/manifold/scrubbers/visible{
	dir = 1
	},
/turf/open/floor/plating/asteroid/whitesands,
/area/whitesands/surface/outdoors/unexplored)
"Za" = (
/obj/item/stack/sheet/metal,
/obj/item/stack/sheet/metal,
/obj/item/stack/sheet/metal,
/obj/machinery/atmospherics/pipe/simple/cyan/visible{
	dir = 8
	},
/turf/open/floor/plating{
	icon_state = "platingdmg1";
	initial_gas_mix = "ws_atmos"
	},
/area/whitesands/surface/outdoors/unexplored)

(1,1,1) = {"
RJ
RJ
RJ
Va
Va
Va
Va
Va
Va
Va
Va
Va
NM
Aj
Va
Va
Va
MC
Va
Va
Va
Va
Va
RJ
RJ
"}
(2,1,1) = {"
RJ
RJ
Va
Va
Va
Va
Va
Va
Va
Va
Va
Wc
se
FZ
hD
wB
Va
MC
Wc
Wc
Wc
Wc
Va
Va
RJ
"}
(3,1,1) = {"
RJ
RJ
Va
Va
Va
Va
Kw
yL
Wc
Va
Va
Wc
ON
Uv
IR
Va
Wc
vl
Wc
Kw
Kw
Kw
Va
Va
RJ
"}
(4,1,1) = {"
RJ
Va
Va
Va
Va
Kw
iQ
Kw
Wc
Wc
Wc
Wc
Wc
Wc
vW
Wc
Wc
yL
Kw
Ki
Kw
Kw
Va
Va
Va
"}
(5,1,1) = {"
RJ
Va
Va
Va
Va
Ki
Ki
yL
tw
Mm
AF
PF
Ki
Kw
Ki
Kw
Ki
rG
rG
ey
EJ
sr
Va
Va
Va
"}
(6,1,1) = {"
RJ
Va
Va
Va
Va
Va
sr
Kw
Ki
Mm
AF
PF
ur
MD
Ku
yL
aM
Ki
yL
wY
Fu
mM
Va
Va
Va
"}
(7,1,1) = {"
Va
Va
Wc
Va
Wc
Wc
tw
Kw
Wc
Wc
Wc
Wc
BY
Kg
Vp
KE
Vp
Vp
Vp
gG
dv
hW
Va
Va
Va
"}
(8,1,1) = {"
Va
Va
Va
fx
Rh
Wc
Kw
iQ
Wc
Ki
PZ
Wc
Wc
pn
yL
Dl
Ki
bV
yL
aM
Dc
Vi
Wc
Va
Va
"}
(9,1,1) = {"
Va
Wc
Wc
sr
Kw
Wc
Dn
EG
Wc
yl
jB
Wc
Wc
ht
Fk
Ki
yL
ue
Pm
yL
Yx
Gi
Va
Va
Va
"}
(10,1,1) = {"
Va
Va
Va
Kw
sr
gT
Fw
fy
vJ
kq
uy
Wc
Wc
Xj
iQ
iQ
Kw
HR
OO
aM
KT
JC
VA
Va
Va
"}
(11,1,1) = {"
Va
Va
Va
ff
iQ
Wc
sr
Tm
Wc
Ki
Ki
Wc
Wc
Wn
Vp
Jl
SR
mb
iD
eR
Jw
HV
mC
Va
Va
"}
(12,1,1) = {"
RJ
Va
Va
Va
rt
Wc
tw
tw
Wc
qF
gr
Wc
Wc
Ki
aM
aM
lm
aM
iQ
aM
aM
aM
vl
Va
Va
"}
(13,1,1) = {"
RJ
Va
Va
Wc
Wc
Wc
vJ
vJ
Wc
Wc
Wc
Wc
Wc
IF
Ym
EF
EI
tv
sZ
wr
oT
mQ
vl
Va
Va
"}
(14,1,1) = {"
RJ
Va
Va
Va
Va
Va
Ki
yL
fm
oO
rO
Wc
Wc
Pl
iQ
Fd
aM
IF
BC
aM
Ki
II
Wc
Va
Va
"}
(15,1,1) = {"
RJ
Va
Va
Va
Va
Va
Kw
Kw
yL
SG
JT
Wc
Wc
Za
uW
Kw
kP
fz
qe
aM
yL
Vf
Va
Va
Va
"}
(16,1,1) = {"
RJ
Av
Va
Va
Va
Va
Kw
Kw
DK
sr
OI
Wc
Wc
Pl
uW
yL
aM
yL
sI
Ki
yL
II
Wc
Va
Va
"}
(17,1,1) = {"
RJ
RJ
Va
Va
Va
Va
Kw
Kw
Kw
Kw
Kw
Wc
Va
uz
oT
oT
Hh
uB
uB
uB
sZ
dJ
Kw
Va
Va
"}
(18,1,1) = {"
RJ
RJ
Va
Va
Va
Kw
Kw
Kw
Kw
Kw
Kw
Va
Va
Va
Va
Va
Va
Ee
JX
JX
Ee
ur
Kw
Va
Va
"}
(19,1,1) = {"
RJ
RJ
Va
Va
Kw
Kw
Ec
yM
Kw
Kw
Va
Va
Va
Va
Va
Va
Va
Pk
Pk
Pk
Pk
Tt
Va
Va
Va
"}
(20,1,1) = {"
RJ
Va
Va
Kw
Kw
hS
LB
Kw
Kw
Va
Va
RJ
RJ
RJ
Va
Va
Va
tw
Vc
Tt
Tt
Va
Va
Va
Va
"}
(21,1,1) = {"
RJ
Va
Va
cG
Kw
Kw
Va
Va
Va
Va
RJ
RJ
RJ
RJ
RJ
Va
Va
Wc
Wc
tw
tw
tw
Va
Va
RJ
"}
(22,1,1) = {"
RJ
Va
Va
Va
Va
Va
Va
Va
RJ
RJ
RJ
RJ
RJ
RJ
RJ
RJ
Va
Va
Wc
vl
Wc
Va
Va
RJ
RJ
"}
(23,1,1) = {"
RJ
RJ
Va
Va
Va
Va
RJ
RJ
RJ
RJ
RJ
RJ
RJ
RJ
RJ
RJ
RJ
RJ
RJ
RJ
RJ
RJ
RJ
RJ
RJ
"}
